0000000000000000000000000
0000000000000000000000000
0000000000000000000000000
0000000000000000000000000
0000000000000000000000000
0000000000000000000000000
0000000000000000000000000
0000000000000000000000000
0000012222222222222300000
00000d6666666666666c00000
00000d6666666666666c00000
00000d6666666666666c00000
000007866666666666a900000
00000078666666666a9000000
00000007bbbbbbbbb90000000
0000000000000000000000000
0000000000000000000000000
0000000000000000000000000